{
    "tileSize": 16,

    "player": {
        "width": 0.95,
        "height": 0.95,
        "color": "rgba(240,0,0,1)",
        
        "static": true,
        "target": "player",
        "shiftHue": "r",
        "shiftAxis": "x",
        "reversed": false,
        
        "position":
        [
            "................",
            ".@..............",
            "................",
            "................",
            "................",
            "................",
            "................",
            "................",
            "................",
            "................",
            "................",
            "................",
            "................",
            "................",
            "................",
            "................"
        ]
    },

    "checkpoint": {
        "position":
        [
            "................",
            "................",
            "................",
            "................",
            "................",
            "................",
            "................",
            "................",
            "................",
            "................",
            "..........#.....",
            "................",
            "................",
            "................",
            "................",
            "................"
        ]
    },
    
    "BG": {
        "color": "rgba(255,255,255,1)",

        "static": true,
        "target": "player",
        "shiftHue": "all",
        "shiftAxis": "x",
        "reversed": false
    },

    "wallLayout": {

        "static": {
            "mono": [
                "0123456789abcdef",
                "................",
                "................",
                "................",
                "................",
                "................",
                "................",
                "................",
                "................",
                "................",
                "................",
                "................",
                "................",
                "................",
                "................",
                "................"
            ],
            "red": [
                "................",
                "...............e",
                "...............d",
                "...............c",
                "...............b",
                "...............a",
                "...............9",
                "...............8",
                "...............7",
                "...............6",
                "...............5",
                "...............4",
                "...............3",
                "...............2",
                "...............1",
                "................"           
            ],
            "green": [
                "................",
                "1...............",
                "2...............",
                "3...............",
                "4...............",
                "5...............",
                "6...............",
                "7...............",
                "8...............",
                "9...............",
                "a...............",
                "b...............",
                "c...............",
                "d...............",
                "e...............",
                "................"
            ],
            "blue": [
                "................",
                "................",
                "................",
                "................",
                "................",
                "................",
                "................",
                "................",
                "................",
                "................",
                "................",
                "................",
                "................",
                "................",
                "................",
                "fedcba9876543210"
            ],
            "alpha": [
                "................",
                "..............0.",
                "..............1.",
                "..............2.",
                "..............3.",
                "..............4.",
                "..............5.",
                "..............6.",
                "..............7.",
                "..............8.",
                "..............9.",
                "..............a.",
                "..............b.",
                "..............c.",
                "................",
                "................"
            ]
        },

        "dynamic": {
            "mono": [
                "................",
                "................",
                "................",
                "................",
                "................",
                "................",
                "................",
                "................",
                "................",
                "................",
                "................",
                "................",
                "................",
                "................",
                ".xXyYzZ.........",
                "................"
            ],
            "red": [
                "................",
                "................",
                "................",
                "................",
                "................",
                "................",
                "................",
                "................",
                "................",
                "................",
                "................",
                "................",
                "................",
                ".xXyYzZ.........",
                "................",
                "................"
            ],
            "green": [
                "................",
                "................",
                "................",
                "................",
                "................",
                "................",
                "................",
                "................",
                "................",
                "................",
                "................",
                "................",
                ".xXyYzZ.........",
                "................",
                "................",
                "................"
            ],
            "blue": [
                "................",
                "................",
                "................",
                "................",
                "................",
                "................",
                "................",
                "................",
                "................",
                "................",
                "................",
                ".xXyYzZ.........",
                "................",
                "................",
                "................",
                "................"
            ],
            "alpha": [
                "................",
                "................",
                "................",
                "................",
                "................",
                "................",
                "................",
                "................",
                "................",
                "................",
                ".xXyYzZ.........",
                "................",
                "................",
                "................",
                "................",
                "................"
            ]
        }
    }
}