{
    "tileSize": 16,

    "player": {
        "width": 0.95,
        "height": 0.95,
        "color": "rgba(240,0,0,1)",
        
        "static": true,
        "target": "player",
        "shiftHue": "r",
        "shiftAxis": "x",
        "reversed": false,
        
        "position":
        [
            "................",
            ".@..............",
            "................",
            "................",
            "................",
            "................",
            "................",
            "................",
            "................",
            "................",
            "................",
            "................",
            "................",
            "................",
            "................",
            "................"
        ]
    },

    "checkpoint": {
        "position":
        [
            "................",
            "................",
            "................",
            "................",
            "................",
            "................",
            "................",
            "................",
            "................",
            "................",
            "................",
            "................",
            "................",
            "................",
            "..............#.",
            "................"
        ]
    },
    
    "BG": {
        "color": "rgba(0,0,0,1)",

        "static": false,
        "target": "player",
        "shiftHue": "all",
        "shiftAxis": "x",
        "reversed": false
    },

    "wallLayout": {

        "static": {
            "mono": [
                "................",
                "................",
                "................",
                "................",
                "................",
                "................",
                "................",
                "................",
                "................",
                "................",
                "................",
                "................",
                "................",
                "................",
                "................",
                "................"
            ],
            "red": [
                "................",
                "................",
                "................",
                "................",
                "................",
                "................",
                "................",
                "................",
                "................",
                "................",
                "................",
                "................",
                "................",
                "................",
                "................",
                "................"         
            ],
            "green": [
                "................",
                "................",
                "................",
                "................",
                "................",
                "................",
                "................",
                "................",
                "................",
                "................",
                "................",
                "................",
                "................",
                "................",
                "................",
                "................"
            ],
            "blue": [
                "................",
                "................",
                "................",
                "................",
                "................",
                "................",
                "................",
                "................",
                "................",
                "................",
                "................",
                "................",
                "................",
                "................",
                "................",
                "................"
            ],
            "alpha": [
                "................",
                "................",
                "................",
                "................",
                "................",
                "................",
                "................",
                "................",
                "................",
                "................",
                "................",
                "................",
                "................",
                "................",
                "................",
                "................"
            ]
        },

        "dynamic": {
            "mono": [
                "................",
                "................",
                "................",
                "................",
                "................",
                "................",
                "................",
                "................",
                "................",
                "................",
                "................",
                "................",
                "................",
                "................",
                "................",
                "................"
            ],
            "red": [
                "................",
                "................",
                "................",
                "................",
                "................",
                "................",
                "................",
                "................",
                "................",
                "................",
                "................",
                "................",
                "................",
                "................",
                "................",
                "................"
            ],
            "green": [
                "................",
                "................",
                "................",
                "................",
                "................",
                "................",
                "................",
                "................",
                "................",
                "................",
                "................",
                "................",
                "................",
                "................",
                "................",
                "................"
            ],
            "blue": [
                "................",
                ".xxx.x.x.xxx....",
                "..x..x.x.x......",
                "..x..xxx.xx.....",
                "..x..x.x.x......",
                "..x..x.x.xxx....",
                "................",
                "................",
                "...xxx.xx..xx...",
                "...x...x.x.x.x..",
                "...xx..x.x.x.x..",
                "...x...x.x.x.x..",
                "...xxx.x.x.xx...",
                "................",
                "................",
                "................"
            ],
            "alpha": [
                "................",
                "................",
                "................",
                "................",
                "................",
                "................",
                "................",
                "................",
                "................",
                "................",
                "................",
                "................",
                "................",
                "................",
                "................",
                "................"
            ]
        }
    }
}