{
    "tileSize": 16,

    "player": {
        "width": 0.95,
        "height": 0.95,
        "color": "rgba(240,0,0,1)",
        
        "static": true,
        "target": "player",
        "shiftHue": "r",
        "shiftAxis": "x",
        "reversed": false,
        
        "position":
        [
            "................",
            ".@..............",
            "................",
            "................",
            "................",
            "................",
            "................",
            "................",
            "................",
            "................",
            "................",
            "................",
            "................",
            "................",
            "................",
            "................"
        ]
    },

    "checkpoint": {
        "position":
        [
            "................",
            "................",
            "................",
            "................",
            "................",
            "................",
            "................",
            "................",
            "................",
            "................",
            "................",
            "................",
            "................",
            "................",
            "..............#.",
            "................"
        ]
    },
    
    "BG": {
        "color": "rgba(15,15,15,1)",

        "static": false,
        "target": "player",
        "shiftHue": "all",
        "shiftAxis": "y",
        "reversed": false
    },

    "wallLayout": {

        "static": {
            "mono": [
                "9999999999999999",
                "9..............9",
                "93.3.3.3.3.3.3.9",
                "9..............9",
                "93.3.3.3.3.3.3.9",
                "9..............9",
                "95.5.5.5.5.5.5.9",
                "9..............9",
                "97.7.7.7.7.7.7.9",
                "9..............9",
                "99.9.9.9.9.9.9.9",
                "9..............9",
                "9b.b.b.b.b.b.b.9",
                "9..............9",
                "9d.d.d.d.d.d.d.9",
                "9999999999999999"
            ],
            "red": [
                "................",
                "................",
                "................",
                "................",
                "................",
                "................",
                "................",
                "................",
                "................",
                "................",
                "................",
                "................",
                "................",
                "................",
                "................",
                "................"         
            ],
            "green": [
                "................",
                "................",
                "................",
                "................",
                "................",
                "................",
                "................",
                "................",
                "................",
                "................",
                "................",
                "................",
                "................",
                "................",
                "................",
                "................"
            ],
            "blue": [
                "................",
                "................",
                "................",
                "................",
                "................",
                "................",
                "................",
                "................",
                "................",
                "................",
                "................",
                "................",
                "................",
                "................",
                "................",
                "................"
            ],
            "alpha": [
                "................",
                "................",
                "................",
                "................",
                "................",
                "................",
                "................",
                "................",
                "................",
                "................",
                "................",
                "................",
                "................",
                "................",
                "................",
                "................"
            ]
        },

        "dynamic": {
            "mono": [
                "................",
                ".....x..........",
                "..x.....x.x.x...",
                ".......x........",
                "..x.x.x...x.x.x.",
                "................",
                "..x.x.x.x.x...x.",
                "................",
                "..x...x.x.x.x.x.",
                "................",
                "..x.x.x.x...x.x.",
                "................",
                "..x...x.x.x.x...",
                ".........x......",
                "..x.x.x.x.x.x...",
                "................"
            ],
            "red": [
                "................",
                "................",
                "................",
                "................",
                "................",
                "................",
                "................",
                "................",
                "................",
                "................",
                "................",
                "................",
                "................",
                "................",
                "................",
                "................"
            ],
            "green": [
                "................",
                "................",
                "................",
                "................",
                "................",
                "................",
                "................",
                "................",
                "................",
                "................",
                "................",
                "................",
                "................",
                "................",
                "................",
                "................"
            ],
            "blue": [
                "................",
                "................",
                "................",
                "................",
                "................",
                "................",
                "................",
                "................",
                "................",
                "................",
                "................",
                "................",
                "................",
                "................",
                "................",
                "................"
            ],
            "alpha": [
                "................",
                "................",
                "................",
                "................",
                "................",
                "................",
                "................",
                "................",
                "................",
                "................",
                "................",
                "................",
                "................",
                "................",
                "................",
                "................"
            ]
        }
    }
}