{
    "tileSize": 16,

    "player": {
        "width": 0.95,
        "height": 0.95,
        "color": "rgba(240,0,0,1)",
        
        "static": true,
        "target": "player",
        "shiftHue": "r",
        "shiftAxis": "x",
        "reversed": false,
        
        "position":
        [
            "................",
            ".@..............",
            "................",
            "................",
            "................",
            "................",
            "................",
            "................",
            "................",
            "................",
            "................",
            "................",
            "................",
            "................",
            "................",
            "................"
        ]
    },

    "checkpoint": {
        "position":
        [
            "................",
            "................",
            "................",
            "................",
            "................",
            "................",
            "................",
            "................",
            "................",
            "................",
            "................",
            "................",
            "................",
            "................",
            "..............#.",
            "................"
        ]
    },
    
    "BG": {
        "color": "rgba(0,0,0,1)",

        "static": false,
        "target": "player",
        "shiftHue": "all",
        "shiftAxis": "x",
        "reversed": false
    },

    "wallLayout": {

        "static": {
            "mono": [
                "................",
                "................",
                "................",
                "................",
                "................",
                "................",
                "................",
                "................",
                "................",
                "................",
                "................",
                "................",
                "................",
                "................",
                "................",
                "................"
            ],
            "red": [
                "................",
                "................",
                "................",
                "................",
                "................",
                "................",
                "................",
                "................",
                "................",
                "................",
                "................",
                "................",
                "................",
                "................",
                "................",
                "................"         
            ],
            "green": [
                "................",
                "................",
                "................",
                "................",
                "................",
                "................",
                "................",
                "................",
                "................",
                "................",
                "................",
                "................",
                "................",
                "................",
                "................",
                "................"
            ],
            "blue": [
                "................",
                "................",
                "................",
                "................",
                "................",
                "................",
                "................",
                "................",
                "................",
                "................",
                "................",
                "................",
                "................",
                "................",
                "................",
                "................"
            ],
            "alpha": [
                "................",
                "................",
                "................",
                "................",
                "................",
                "................",
                "................",
                "................",
                "................",
                "................",
                "................",
                "................",
                "................",
                "................",
                "................",
                "................"
            ]
        },

        "dynamic": {
            "mono": [
                "yyyyyyyyyyyyyyyy",
                "y...y...y.y...yy",
                "yyy.y.y.y.y.y.yy",
                "y.....y.y...y.yy",
                "y.YYYyy.y.y.y.yy",
                "y.y.y.y.y.y.y.yy",
                "y.y.y.y.y.y.y.yy",
                "y...y.....y.y.yy",
                "yyyyy.YYYyy.y.yy",
                "y.........yyy.yy",
                "yyyyyy.yyyy...yy",
                "y...........yyyy",
                "yy.yyyyyyyYYY.yy",
                "y..............y",
                "yyyyyyyyyyyyyy.y",
                "yyyyyyyyyyyyyyyy"
            ],
            "red": [
                "................",
                "................",
                "................",
                "................",
                "................",
                "................",
                "................",
                "................",
                "................",
                "................",
                "................",
                "................",
                "................",
                "................",
                "................",
                "................"
            ],
            "green": [
                "................",
                "................",
                "................",
                "................",
                "................",
                "................",
                "................",
                "................",
                "................",
                "................",
                "................",
                "................",
                "................",
                "................",
                "................",
                "................"
            ],
            "blue": [
                "................",
                "................",
                "................",
                "................",
                "................",
                "................",
                "................",
                "................",
                "................",
                "................",
                "................",
                "................",
                "................",
                "................",
                "................",
                "................"
            ],
            "alpha": [
                "................",
                "................",
                "................",
                "................",
                "................",
                "................",
                "................",
                "................",
                "................",
                "................",
                "................",
                "................",
                "................",
                "................",
                "................",
                "................"
            ]
        }
    }
}