{
    "tileSize": 16,

    "player": {
        "width": 0.95,
        "height": 0.95,
        "color": "rgba(240,0,0,1)",
        
        "static": true,
        "target": "player",
        "shiftHue": "r",
        "shiftAxis": "x",
        "reversed": false,
        
        "position":
        [
            "................",
            ".@..............",
            "................",
            "................",
            "................",
            "................",
            "................",
            "................",
            "................",
            "................",
            "................",
            "................",
            "................",
            "................",
            "................",
            "................"
        ]
    },

    "checkpoint": {
        "position":
        [
            "................",
            "................",
            "................",
            "................",
            "................",
            "................",
            "................",
            "................",
            "................",
            "................",
            "................",
            "................",
            "................",
            "................",
            "..............#.",
            "................"
        ]
    },
    
    "BG": {
        "color": "rgba(0,0,0,1)",

        "static": false,
        "target": "player",
        "shiftHue": "r",
        "shiftAxis": "xy",
        "reversed": false
    },

    "wallLayout": {

        "static": {
            "mono": [
                "................",
                "................",
                "................",
                "................",
                "................",
                "................",
                "................",
                "................",
                "................",
                "................",
                "................",
                "................",
                "................",
                "................",
                "................",
                "................"
            ],
            "red": [
                "1111111111111111",
                "1....1.1.1.1.1.1",
                "1..2.4.6...7...1",
                "1122.1.1.1.1.1.1",
                "1....4.6.7.1.c.1",
                "14.144...1.8.1.1",
                "1......6.6.1.c.1",
                "11414166.1.1.1.1",
                "1........8.8.c.1",
                "1111618188.1.1.1",
                "1..........a.c.1",
                "118118.181aa.1.1",
                "1............c.1",
                "11c11c.11111cc.1",
                "1.......d......1",
                "1111111111111111"       
            ],
            "green": [
                "................",
                "................",
                "................",
                "................",
                "................",
                "................",
                "................",
                "................",
                "................",
                "................",
                "................",
                "................",
                "................",
                "................",
                "................",
                "................"
            ],
            "blue": [
                "................",
                "................",
                "................",
                "................",
                "................",
                "................",
                "................",
                "................",
                "................",
                "................",
                "................",
                "................",
                "................",
                "................",
                "................",
                "................"
            ],
            "alpha": [
                "................",
                "................",
                "................",
                "................",
                "................",
                "................",
                "................",
                "................",
                "................",
                "................",
                "................",
                "................",
                "................",
                "................",
                "................",
                "................"
            ]
        },

        "dynamic": {
            "mono": [
                "................",
                "................",
                "................",
                "................",
                "................",
                "................",
                "................",
                "................",
                "................",
                "................",
                "................",
                "................",
                "................",
                "................",
                "................",
                "................"
            ],
            "red": [
                "................",
                "................",
                "................",
                "................",
                "................",
                "................",
                "................",
                "................",
                "................",
                "................",
                "................",
                "................",
                "................",
                "................",
                "................",
                "................"
            ],
            "green": [
                "................",
                "................",
                "................",
                "................",
                "................",
                "................",
                "................",
                "................",
                "................",
                "................",
                "................",
                "................",
                "................",
                "................",
                "................",
                "................"
            ],
            "blue": [
                "................",
                "................",
                "................",
                "................",
                "................",
                "................",
                "................",
                "................",
                "................",
                "................",
                "................",
                "................",
                "................",
                "................",
                "................",
                "................"
            ],
            "alpha": [
                "................",
                "................",
                "................",
                "................",
                "................",
                "................",
                "................",
                "................",
                "................",
                "................",
                "................",
                "................",
                "................",
                "................",
                "................",
                "................"
            ]
        }
    }
}