{
    "tileSize": 16,

    "player": {
        "width": 0.95,
        "height": 0.95,
        "color": "rgba(240,0,0,1)",
        
        "static": false,
        "target": "player",
        "shiftHue": "r",
        "shiftAxis": "xy",
        "reversed": true,
        
        "position":
        [
            "................",
            ".@..............",
            "................",
            "................",
            "................",
            "................",
            "................",
            "................",
            "................",
            "................",
            "................",
            "................",
            "................",
            "................",
            "................",
            "................"
        ]
    },

    "checkpoint": {
        "position":
        [
            "................",
            "................",
            "................",
            "................",
            "................",
            "................",
            "................",
            "................",
            "................",
            "................",
            "................",
            "................",
            "................",
            "................",
            "..............#.",
            "................"
        ]
    },
    
    "BG": {
        "color": "rgba(0,0,0,1)",

        "static": true,
        "target": "player",
        "shiftHue": "all",
        "shiftAxis": "x",
        "reversed": true
    },

    "wallLayout": {

        "static": {
            "mono": [
                "................",
                "................",
                "................",
                "................",
                "................",
                "................",
                "................",
                "................",
                "................",
                "................",
                "................",
                "................",
                "................",
                "................",
                "................",
                "................"
            ],
            "red": [
                "................",
                "................",
                "................",
                "................",
                "................",
                "................",
                "................",
                "................",
                "................",
                "................",
                "................",
                "................",
                "................",
                "................",
                "................",
                "................"         
            ],
            "green": [
                "................",
                "................",
                "................",
                "................",
                "................",
                "................",
                "................",
                "................",
                "................",
                "................",
                "................",
                "................",
                "................",
                "................",
                "................",
                "................"
            ],
            "blue": [
                "................",
                "................",
                "................",
                "................",
                "................",
                "................",
                "................",
                "................",
                "................",
                "................",
                "................",
                "................",
                "................",
                "................",
                "................",
                "................"
            ],
            "alpha": [
                "................",
                "................",
                "................",
                "................",
                "................",
                "................",
                "................",
                "................",
                "................",
                "................",
                "................",
                "................",
                "................",
                "................",
                "................",
                "................"
            ]
        },

        "dynamic": {
            "mono": [
                "................",
                "................",
                "................",
                "................",
                "................",
                "................",
                "................",
                "................",
                "................",
                "................",
                "................",
                "................",
                "................",
                "................",
                "................",
                "................"
            ],
            "red": [
                "................",
                "................",
                "................",
                "................",
                "................",
                "................",
                "................",
                "................",
                "................",
                "................",
                "................",
                "................",
                "................",
                "................",
                "................",
                "................"
            ],
            "green": [
                "zzzzz...........",
                "z...z...........",
                "zzz.zzz.........",
                "..z...z.........",
                "..zzz.zzz.......",
                "....z...z.......",
                "....zzz.zzz.....",
                "......z...z.....",
                "......zzz.zzz...",
                "........z...z...",
                "........zzz.zzzz",
                "..........z....z",
                "..........zzzz.z",
                ".............z.z",
                ".............z.z",
                ".............zzz"
            ],
            "blue": [
                "................",
                "................",
                "................",
                "................",
                "................",
                "................",
                "................",
                "................",
                "................",
                "................",
                "................",
                "................",
                "................",
                "................",
                "................",
                "................"
            ],
            "alpha": [
                "................",
                "................",
                "................",
                "................",
                "................",
                "................",
                "................",
                "................",
                "................",
                "................",
                "................",
                "................",
                "................",
                "................",
                "................",
                "................"
            ]
        }
    }
}