{
    "tileSize": 16,

    "player": {
        "width": 0.95,
        "height": 0.95,
        "color": "rgba(255,0,0,1)",
        
        "static": false,
        "target": "player",
        "shiftHue": "a",
        "shiftAxis": "x",
        "reversed": true,
        
        "position":
        [
            "................",
            ".@..............",
            "................",
            "................",
            "................",
            "................",
            "................",
            "................",
            "................",
            "................",
            "................",
            "................",
            "................",
            "................",
            "................",
            "................"
        ]
    },

    "checkpoint": {
        "position":
        [
            "................",
            "................",
            "................",
            "................",
            "................",
            "................",
            "................",
            "................",
            "................",
            "................",
            "................",
            "................",
            "................",
            "................",
            "..............#.",
            "................"
        ]
    },
    
    "BG": {
        "color": "rgba(255,0,0,1)",

        "static": false,
        "target": "player",
        "shiftHue": "g",
        "shiftAxis": "x",
        "reversed": true
    },

    "wallLayout": {

        "static": {
            "mono": [
                "................",
                "................",
                "................",
                "................",
                "................",
                "................",
                "................",
                "................",
                "................",
                "................",
                "................",
                "................",
                "................",
                "................",
                "................",
                "................"
            ],
            "red": [
                "................",
                "................",
                "................",
                "................",
                "................",
                "................",
                "................",
                "................",
                "................",
                "................",
                "................",
                "................",
                "................",
                "................",
                "................",
                "................"       
            ],
            "green": [
                "................",
                "................",
                "................",
                "................",
                "................",
                "................",
                "................",
                "................",
                "................",
                "................",
                "................",
                "................",
                "................",
                "................",
                "................",
                "................"
            ],
            "blue": [
                "................",
                "................",
                "................",
                "................",
                "................",
                "................",
                "................",
                "................",
                "................",
                "................",
                "................",
                "................",
                "................",
                "................",
                "................",
                "................"
            ],
            "alpha": [
                "................",
                "................",
                "................",
                "................",
                "................",
                "................",
                "................",
                "................",
                "................",
                "................",
                "................",
                "................",
                "................",
                "................",
                "................",
                "................"
            ]
        },

        "dynamic": {
            "mono": [
                "................",
                "................",
                "..zzzzzzzzzzzz.z",
                "..z............z",
                "..z.............",
                "..z.............",
                "..z.............",
                "..z.............",
                "..z.............",
                "..z.............",
                "..z.............",
                "..z.............",
                "..z.............",
                "..z.............",
                "..z.............",
                "..zz............"
            ],
            "red": [
                "zzzzzzzzzzzzzzzz",
                "z..............z",
                "z...............",
                "z...............",
                "z...............",
                "z...............",
                "z...............",
                "z...............",
                "z...............",
                "z...............",
                "z.........ZZZZ.Z",
                "z.........Z....Z",
                "z.........Z.....",
                "z.........Z.....",
                "z.........Z.....",
                "zz........ZZ...." 
            ],
            "green": [
                "................",
                "................",
                "................",
                "................",
                "....zzzzzzzzzzzz",
                "....z..........z",
                "....z...........",
                "....z...........",
                "....z...........",
                "....z...........",
                "....z...........",
                "....z...........",
                "....z...........",
                "....z...........",
                "................",
                "....zz.........."
            ],
            "blue": [
                "................",
                "................",
                "................",
                "................",
                "................",
                "................",
                "......zzzz.zzzzz",
                "......z........z",
                "......z.........",
                "......z.........",
                "......z.........",
                "......z.........",
                "......z.....ZZZZ",
                "......z.....Z..Z",
                "......z........Z",
                "......zz....ZZZZ"
            ],
            "alpha": [
                "................",
                "................",
                "................",
                "................",
                "................",
                "................",
                "................",
                "................",
                "........zzzzzzzz",
                "........z......z",
                "........z.......",
                "........z.......",
                "................",
                "........z.......",
                "........z.......",
                "........zz......"
            ]
        }
    }
}