{
    "tileSize": 16,

    "player": {
        "width": 0.95,
        "height": 0.95,
        "color": "rgba(240,0,0,1)",
        
        "static": true,
        "target": "player",
        "shiftHue": "r",
        "shiftAxis": "x",
        "reversed": false,
        
        "position":
        [
            "................",
            ".@..............",
            "................",
            "................",
            "................",
            "................",
            "................",
            "................",
            "................",
            "................",
            "................",
            "................",
            "................",
            "................",
            "................",
            "................"
        ]
    },

    "checkpoint": {
        "position":
        [
            "................",
            "................",
            "................",
            "................",
            "................",
            "................",
            "................",
            "................",
            "................",
            "................",
            "................",
            "................",
            "................",
            "................",
            "..............#.",
            "................"
        ]
    },
    
    "BG": {
        "color": "rgba(0,0,10,1)",

        "static": false,
        "target": "player",
        "shiftHue": "b",
        "shiftAxis": "y",
        "reversed": false
    },

    "wallLayout": {

        "static": {
            "mono": [
                "................",
                "................",
                "................",
                "................",
                "................",
                "................",
                "................",
                "................",
                "................",
                "................",
                "................",
                "................",
                "................",
                "................",
                "................",
                "................"
            ],
            "red": [
                "................",
                "................",
                "................",
                "................",
                "................",
                "................",
                "................",
                "................",
                "................",
                "................",
                "................",
                "................",
                "................",
                "................",
                "................",
                "................"         
            ],
            "green": [
                "................",
                "................",
                "................",
                "................",
                "................",
                "................",
                "................",
                "................",
                "................",
                "................",
                "................",
                "................",
                "................",
                "................",
                "................",
                "................"
            ],
            "blue": [
                "eeeeeee111111111",
                "e.....e........1",
                "e.eee.e131.131.1",
                "1.1.e.e......1.1",
                "1.1.e.e61.1511.1",
                "1.1.e.e......1.1",
                "1.1.e.e17191.1.1",
                "1.1.e.e......1.1",
                "1.1.e.e91.1b11.1",
                "1.1.e1e......1.1",
                "1.1...e1.1b1e1.1",
                "1.1.e.e......1.1",
                "1.1.e.e......1.1",
                "1.1.e.eeeeee.e.e",
                "1...e........1.e",
                "1111eeeeeeeeeeee"
            ],
            "alpha": [
                "................",
                "................",
                "................",
                "................",
                "................",
                "................",
                "................",
                "................",
                "................",
                "................",
                "................",
                "................",
                "................",
                "................",
                "................",
                "................"
            ]
        },

        "dynamic": {
            "mono": [
                "................",
                "................",
                "................",
                "................",
                "................",
                "................",
                "................",
                "................",
                "................",
                "................",
                "................",
                "................",
                "................",
                "................",
                "................",
                "................"
            ],
            "red": [
                "................",
                "................",
                "................",
                "................",
                "................",
                "................",
                "................",
                "................",
                "................",
                "................",
                "................",
                "................",
                "................",
                "................",
                "................",
                "................"
            ],
            "green": [
                "................",
                "................",
                "................",
                "................",
                "................",
                "................",
                "................",
                "................",
                "................",
                "................",
                "................",
                "................",
                "................",
                "................",
                "................",
                "................"
            ],
            "blue": [
                "................",
                "................",
                "................",
                "................",
                "................",
                "................",
                "................",
                "................",
                "................",
                "................",
                "................",
                "................",
                "................",
                "................",
                "................",
                "................"
            ],
            "alpha": [
                "................",
                "................",
                "................",
                "................",
                "................",
                "................",
                "................",
                "................",
                "................",
                "................",
                "................",
                "................",
                "................",
                "................",
                "................",
                "................"
            ]
        }
    }
}